{
	"tilesX":13,
	"tilesY":10,
	"size":[64, 64],
	"start":[16, 16],
	"tileNames":["", "grass", "dirt", "stone", "coin"],
	"tiles":[
		0, 0, 0, 0, 0, 0, 0, 0, 0, 0, 0, 0, 0,
		0, 0, 0, 0, 0, 0, 0, 0, 0, 0, 0, 0, 0,
		0, 0, 0, 0, 0, 0, 0, 0, 0, 0, 0, 0, 0,
		0, 0, 0, 0, 0, 0, 0, 0, 0, 4, 0, 0, 0,
		0, 1, 1, 1, 1, 0, 0, 0, 0, 0, 0, 0, 0,
		1, 2, 2, 2, 2, 1, 1, 1, 0, 0, 0, 0, 1,
		2, 2, 2, 2, 2, 2, 2, 2, 1, 1, 1, 1, 2,
		2, 3, 3, 3, 3, 2, 2, 2, 2, 2, 2, 2, 2,
		3, 3, 3, 3, 3, 3, 3, 3, 2, 2, 2, 2, 3,
		3, 3, 3, 3, 3, 3, 3, 3, 3, 3, 3, 3, 3 
	]
}